2 2 2 20 798 18 798 4 
21 1 25 599 2 599 3 1 
2 584 799 582 799 596 2 596 
776 3 796 4 795 598 788 597 
183 175 185 201 8 196 9 175 
261 176 259 203 308 200 309 176 
307 14 303 199 336 200 339 14 
328 141 330 165 389 168 388 142 
444 145 447 167 492 168 494 146 502 13 459 12 461 146 
476 163 493 162 490 212 476 210 
479 273 502 270 484 332 507 334 
478 275 481 330 509 334 504 269 
483 331 792 324 792 357 485 369 
485 361 494 482 524 480 520 358 
503 545 523 544 532 593 502 588 
495 480 459 500 455 469 503 475 
460 500 525 502 523 482 492 484 
458 543 525 540 524 560 458 562 
455 471 460 502 527 502 523 470 
174 324 129 372 121 432 134 501 188 526 225 534 257 522 287 497 303 455 292 417 274 379 247 351 223 338 
623 250 633 300 701 304 699 254 

